11111111111111111111111111111
10000000000000000000000000001
10000001000000000000000000001
10000000000000000000000000001
10000001000000000000000000001
10000001000000000000000000001
10000001000000000000000000001
10000001000000000000000000001
10000001000000000000000000001
10000001000000000000000000001
10000001000000000000000000001
10000001000000000000000000001
10000001000000000000000000001
10000001000000000000000000001
10000001000000000000000000001
11000000100000000000000000001
10000001000000000000000000001
10000001000000000000000000001
10000001000000000000000000001
10000001000000000000000000001
10000001000000000000000000001
10000001000000000000000000001
11111111111111111111111111111